"filename", "language", "Java", "comment", "blank", "total"
"e:\java class\IdeaProjects\mtgprice\src\main\java\com\aca\mtgprice\controller\CardController.java", "Java", 54, 0, 19, 73
"e:\java class\IdeaProjects\mtgprice\src\main\java\com\aca\mtgprice\controller\ExceptionHandlerController.java", "Java", 18, 0, 8, 26
"e:\java class\IdeaProjects\mtgprice\src\main\java\com\aca\mtgprice\controller\MtgPriceApplication.java", "Java", 9, 0, 5, 14
"e:\java class\IdeaProjects\mtgprice\src\main\java\com\aca\mtgprice\dao\CardDao.java", "Java", 18, 0, 15, 33
"e:\java class\IdeaProjects\mtgprice\src\main\java\com\aca\mtgprice\dao\CardDaoImpl.java", "Java", 396, 0, 47, 443
"e:\java class\IdeaProjects\mtgprice\src\main\java\com\aca\mtgprice\dao\CardDaoMock.java", "Java", 121, 0, 21, 142
"e:\java class\IdeaProjects\mtgprice\src\main\java\com\aca\mtgprice\dao\MariaDbUtil.java", "Java", 27, 0, 8, 35
"e:\java class\IdeaProjects\mtgprice\src\main\java\com\aca\mtgprice\model\Card.java", "Java", 80, 0, 24, 104
"e:\java class\IdeaProjects\mtgprice\src\main\java\com\aca\mtgprice\model\CardException.java", "Java", 6, 0, 2, 8
"e:\java class\IdeaProjects\mtgprice\src\main\java\com\aca\mtgprice\model\Code.java", "Java", 14, 0, 5, 19
"e:\java class\IdeaProjects\mtgprice\src\main\java\com\aca\mtgprice\model\ExceptionResponse.java", "Java", 17, 0, 6, 23
"e:\java class\IdeaProjects\mtgprice\src\main\java\com\aca\mtgprice\model\Rarity.java", "Java", 14, 0, 5, 19
"e:\java class\IdeaProjects\mtgprice\src\main\java\com\aca\mtgprice\model\Type.java", "Java", 31, 2, 10, 43
"e:\java class\IdeaProjects\mtgprice\src\main\java\com\aca\mtgprice\service\CardService.java", "Java", 41, 0, 16, 57
"e:\java class\IdeaProjects\mtgprice\src\main\java\com\aca\mtgprice\util\DbConfig.java", "Java", 26, 0, 7, 33
"Total", "-", 872, 2, 198, 1072